##########
#....#...#
#....#...#
##.@.....#
##..#....#
##..#....#
#....#...#
#....##..#
#....#...#
##########