###....#..
.......#..
..###..#..
.#.....#..
.#..#..#..
.#..#..#..
.......#..
....@.....
..####....
..........