#.######.#
#........#
#........#
#.........
#.@.......
#...##...#
.........#
#........#
#........#
###....###